1111111111111
1P00000M001C1
10000111100M1
10C001E0M00C1
1111111111111