1111111111111111111111111111111111
1P1C000M0M0M000CM0000CM0000M000001
101M01010000C0C01010010C000M010101
100001000MCMC0CC0010M1000000010101
1E000000MMMCCM00000M00000M00000MC1
1111111111111111111111111111111111